11111111111111111111111111
10100000010001000001000001
100P0100000C0C001000001101
1000010000C000C010000010E1
11111111111111111111111111