1111111111111111111111111111111
1111111111111111111111111111111
1010000001000100000100000111111
100P0100000C0C00100000110111111
1000010000C000C010000010E111111
1111111111111111111111111111111
1111111111111111111111111111111
1111111111111111111111111111111